11111111    11111   1111 1 1 1
10000    00000000 00000 0 1
100    00000000000000001
1000    0000000000000001
100000    0000000     0000001
     10000000000000000001
     10    00000000000    000000                    1
100000000000N0000001
10000000000N00000001
110000000001111111001
  1000000001     1001
       1111111      111111111111		1


NO ./path_to_the_north_texture
SO ./path_to_the_south_texture
WE ./path_to_the_west_texture
EA ./path_to_the_east_texture

F 220,100,0
C 225,30,0
