NO textures/respawn_anchor_side0.xpm
SO textures/respawn_anchor_side2.xpm
WE textures/respawn_anchor_side3.xpm
EA textures/respawn_anchor_side4.xpm

F 220,100,0
C 225,30,0

	111111111111111111111111111111111111111111111111111111
	100000000011000000000000000000000000000000000000000001
	101100000111000000000000111111111111111111111111111111
	1001000000000000000000001
	1111111110110000011100001
	100000000011000001110111 111
	11110111111111011100000010001
	11110111111111011101010010001
	11000000110101011100000010001
	10000000S00000001100000010001
	10000000000000001101010010001
	1100000111010101111101111000111
	11110111 1110101 101111010001
	11111111 1111111 111111111111