NO textures/respawn_anchor_side0.xpm
SO textures/respawn_anchor_side2.xpm
WE textures/respawn_anchor_side3.xpm
EA textures/respawn_anchor_side4.xpm

F 100,100,0
C 50,30,45

11111111111111111111111111111111111111111111111111111111111111111111
10100000000000000100000000000000000000000000000000010000000000000001
10110111111100000010000100000000000000000000000000010000000000000001
10000100100111000001111111111111111111111100000000010000000000000001
10100110100001000000000100000001000000000100000000001000000000000001
10100000100001111100000100000001000000000100000000000111111111111101
10101111101111000000000100010001000000000100000000010000000000000001
10100010100100000000000111110001000000000100000000111000000001000001
11111010000100000000000100010001100000001100010000010000000011100001
10001010101000000000000100010000010000011000111000000000000001000001
10111000101000000000000100011111110000110000010000010000000000000001
10111111101011111111111100000000000001100000000000111001000000100001
10100000001000000000000000000000000011000000000000010011100001110001
10101111101000000000111111111110111110000100000000000001000000100001
10101111101100000000100000101010001100001110000000000000000000000001
10101100100100000000101110101010011100000100001000001111111111111101
10000100100100000000101000100010101110000000011100001111100000000001
10111000111100000000101011101010000111000W00001000001100000000000001
10000000000100000000001000001000000000000000000000001111100000000001
11111111111111111111111111111111111111111111111111111111111111111111