NO textures/respawn_anchor_side0.xpm
SO textures/respawn_anchor_side2.xpm
WE textures/respawn_anchor_side3.xpm
EA textures/respawn_anchor_side4.xpm

F 100,100,0
C 50,30,45

                                    111111111111111111111111111111111111
                                    100000000000000000000000000000000001
                                    101111111111111111111111111111111001
                                    1011                            1001
                                    1011  111111111111111111111111111001
                                    1011  100000000000000000000000000001 
                                    1011  100111111111111111111111111111
                                    1011  1001
                                    1011  1001          1111111111111111111
                                    1011  1001          1000000000000000001
                                    1011  1001          1011111111111111001
                                    1011  1001          101            1001
11111111111111111111111111111111111110111110111111111111101111111111   1001
101000000000000001000000001  100000010100000000000010000000000000001   1001
101101111111000000100001001  1000000101000000000000100000000000000011111001
100001001001110000011111111111111111101111000000000100000000000000000001001
101001101000010000000001000000010000101001000000000010000000000000011101101
101000001000011111000001000000010000101001000000000001111111111111011101101
101011111011110000000001000100010000101001000000000100000000000000011101101
101000101001001111111101111100010000000001000000001110000000010000011100001
111110100001001      101000100011000000011000100000100000000111000000111111
1000101010100011111111010001000001111111100011100000000000000100000111
10111000101000000000000100011111110000110000010000010000000000000001
10111111101011111111111100000000000001100000000000111001000000100001
10100000001000000000000000000000000011000000000000010011100001110001
10101111101000000000111111111110111110000100000000000001000000100001
10101111101100000000100000101010001100001110000000000000000000000001
10101100100100011100101110101010011100000100001000001111111111111101
1000010010010001 10010100010001010111000000001110000111110000000000111111111111
1011100011110001110010101110101000011100000000100000110000000000000000000000001
100000000001000000000010000010000000000000000000000111110000000000111111111111
11111111111111111111111111111111111111111001111111111111111111111111
                                        1001
                                        1001
                                        1001
                                        1001
                                        1001
                                        1001
                                111111111001
                                100000000001
                                110111111001
                                 101    1001
                                 111    1001
                                        1001
                                        1001
                                        1001
                                        1001
                                        1001
                                        1001
                                        1001
                                        1001
                                        1001
                                        1001
                                        1001
                                        1001
                                        1001
                                        1001
                                        1001
                                        1001
                                        10S1
                                        1111