NO textures/respawn_anchor_side0.xpm
SO textures/respawn_anchor_side2.xpm
WE textures/respawn_anchor_side3.xpm
EA textures/respawn_anchor_side4.xpm

F 100,100,0
C 50,30,45

11111111111111111111111111111111111111111111111111111111111111111111
100000000000000000000010000000N0000000000000000000000000000000000001
11111111111111111111111111111111111111111111111111111111111111111111
