NO textures/Sans-titre.xpm
SO textures/Sans-titre.xpm
WE textures/Sans-titre.xpm
EA textures/Sans-titre.xpm

F 100,100,0
C 50,30,45,

11111111111111111111111111111111111111111111111111111111111111111111
1W000001000000000000000000000000000000000000000000000000000000000001
11111111111111111111111111111111111111111111111111111111111111111111
