NO textures/respawn_anchor_side0.xpm
SO textures/respawn_anchor_side2.xpm
WE textures/respawn_anchor_side3.xpm
EA textures/respawn_anchor_side4.xpm

F 220,100,0
C 225,30,0

	1111111111111111111111111
	1000000000110000000000001
	1011000001110000000000001
	1001000000000000000000001
	1111111110110000011100001
	100000000011000001110111 111
	11110111111111011100000010001
	11110111111111011101010010001
	11001000110101011100000010001
	10001000000000001100000010001
	10001000000000001101010010001
	10000000000000001101010010001
	11110000000000010001010010001
	10000000000011111111010010011
	100100000000100000010100101
	11110000000010100W0010100101
	100100000000001111110100101
	100110000000000000010100101
	100010000000110000010100101
	10000000000100000001010010011
	1111100000000001101010010001
	10000000000000001101010010001
	1100000111010101111101111000111
	11110111 1110101 101111010001
	11111111 1111111 111111111111