NO textures/respawn_anchor_side0.xpm
SO textures/respawn_anchor_side2.xpm
WE textures/respawn_anchor_side3.xpm
EA textures/respawn_anchor_side4.xpm

F 220,100,0
C 225,30,0

1111111111111111111111111111111111111111111111111111111111111111111
1010000000000000100000000000000000000000000000000000000000000000001
1011010011100000010000100000000000000000000000000000000000000000001
1010010010111000001111111111111111111111100000000000000000000000001
1010011110001000000000000000001000000000100000000000000000000000001
1010000000001111100000100000001000000000100000000000000000000000001
1000111111111000000000100010001000000000100000000000000000000000001
1010000000100000000000111110001000000000100000000000000000000000001
1111110000100000000000100010001100000001100000000000000000000000001
1000101101000000000000100010000010000011000000000000000000000000001
1011100001000000000000100011111110000110000000000000000000000000001
1011111101011111111100100000000000001100000000000000000000000000001
1010000001000000000000000000000000011000000000000000000000000000001
1010111101000000000111111111110111110000000000000000000000000000001
1010111111100000000100000101010001100000000000000000000000000000001
1010110010100000000101110101010011100000000000000000000000000000001
1000010010100000000101000100010101110000000000000000000000000000001
1011100011100000000101011101010000111000000000000000000000000000001
100000N000100000000001000001000000000000000000000000000000000000001
1111111111111111111111111111111111111111111111111111111111111111111