NO textures/respawn_anchor_side0.xpm
SO textures/respawn_anchor_side2.xpm
WE textures/respawn_anchor_side3.xpm
EA textures/respawn_anchor_side4.xpm

F 220,100,0
C 225,30,0

1111111111111111111111111111111111111111111111111111111111111111111
1000000000000000100000000000000000000000000000000000000000000000001
1011110011100000010000100000000000000000000000000000000000000000001
1010010010111000001111100000000000000000000000000000000000000000001
1010011110001000010000000000000000000000000000000000000000000000001
1010000000001111100000000000000000000000000000000000000000000000001
1000111111111000000000000000000000000000000000000000000000000000001
1010000000100000000000000000000000000000000000000000000000000000001
1111110000100000000000000000000000000000000000000000000000000000001
1000101101000000000000000000000000000000000000000000000000000000001
1011100001000000000000000000000000000000000000000000000000000000001
1011111101000000000000000000000000000000000000000000000000000000001
1010000001000000000000000000000000000000000000000000000000000000001
1010111101000000000000000000000000000000000000000000000000000000001
1010111111100000000000000000000000000000000000000000000000000000001
1010110N10100000000000000000000000000000000000000000000000000000001
1000010010100000000000000000000000000000000000000000000000000000001
1011100011100000000000000000000000000000000000000000000000000000001
1000000000100000000000000000000000000000000000000000000000000000001
1111111111111111111111111111111111111111111111111111111111111111111